#;#;#;M;M;#;#;D;#;#;#;M;#;#;#
#;M;#;#;M;#;M;#;M;M;#;#;#;M;#
#;#;M;#;#;#;M;#;#;#;#;M;M;M;M
M;#;M;M;M;M;M;M;M;M;#;#;#;#;M
#;#;M;#;#;#;M;#;#;#;M;M;M;#;M
M;M;M;M;M;#;#;#;M;#;#;#;#;#;M
M;#;#;#;#;M;M;#;M;M;M;M;M;M;M
M;#;M;M;#;#;#;#;#;#;#;M;#;#;#
M;#;#;#;#;M;M;M;M;M;#;M;#;M;#
M;M;#;M;M;#;#;#;#;M;#;M;#;M;#
#;#;#;#;M;#;M;M;M;M;#;#;#;M;#
#;M;M;#;#;#;M;#;#;#;#;M;M;M;#
#;#;#;M;M;M;M;M;M;M;M;M;M;M;M
M;M;#;#;#;#;#;M;#;#;#;M;#;#;#
#;#;#;M;M;M;#;#;#;M;#;#;#;M;G