###MM##D###M###
#M##M#M#MM###M#
##M###M####MMMM
M#MMMMMMMM####M
##M###M###MMM#M
MMMMM###M#####M
M####MM#MMMMMMM
M#MM#######M###
M####MMMMM#M#M#
MM#MM####M#M#M#
####M#MMMM###M#
#MM###M####MMM#
###MMMMMMMMMMMM
MM#####M###M###
###MMM###M###MG